    { 1, 1, 1, 1, 1, 1, 1, 1, 1, 1, 1, 1, 1, 1, 1, 1, 1, 1, 1, 1, 1, 1, 1, 1, 1, 1, 1, 1, 1, 1, 1, 1, 1, 1, 1, 1, 1, 1, 1, 1, 1, 1, 1, 1, 1, 1, 1, 1, 1, 1, 1, 1, 1 },
    { 1, 1, 1, 1, 1, 1, 1, 1, 1, 1, 1, 1, 1, 1, 1, 1, 1, 1, 1, 1, 1, 1, 1, 1, 1, 1, 1, 1, 1, 1, 1, 1, 1, 1, 1, 1, 1, 1, 1, 1, 1, 1, 1, 1, 1, 1, 1, 1, 1, 1, 1, 1, 1 },
    { 1, 1, 1, 0, 1, 0, 1, 0, 1, 0, 1, 1, 1, 1, 7, 1, 2, 1, 2, 1, 2, 1, 2, 1, 2, 1, 9, 1, 2, 1, 2, 1, 2, 1, 2, 1, 2, 1, 2, 1, 1, 1, 1, 0, 1, 0, 1, 0, 1, 0, 1, 1, 1 },
    { 1, 1, 1, 3, 1, 3, 1, 3, 1, 3, 1, 1, 1, 1, 0, 1, 3, 1, 3, 1, 0, 1, 3, 1, 3, 1, 0, 1, 3, 1, 3, 1, 0, 1, 3, 1, 3, 1, 0, 1, 1, 1, 1, 3, 1, 3, 1, 3, 1, 3, 1, 1, 1 },
    { 1, 1, 0, 0, 0, 0, 0, 0, 0, 0, 0, 1, 1, 2, 0, 2, 0, 2, 0, 2, 0, 2, 0, 2, 0, 2, 0, 2, 0, 2, 0, 2, 0, 2, 0, 2, 0, 2, 0, 2, 1, 1, 0, 0, 0, 0, 0, 0, 0, 0, 0, 1, 1 },
    { 1, 1, 1, 0, 1, 3, 1, 0, 1, 3, 1, 1, 1, 1, 0, 1, 3, 1, 3, 1, 0, 1, 3, 1, 3, 1, 3, 1, 3, 1, 3, 1, 0, 1, 3, 1, 3, 1, 0, 1, 1, 1, 1, 0, 1, 3, 1, 0, 1, 3, 1, 1, 1 },
    { 1, 1, 1, 3, 1, 2, 1, 3, 1, 0, 1, 1, 1, 1, 2, 1, 2, 1, 2, 1, 2, 1, 2, 1, 2, 1, 2, 1, 2, 1, 2, 1, 2, 1, 2, 1, 2, 1, 8, 1, 1, 1, 1, 3, 1, 0, 1, 3, 1, 0, 1, 1, 1 },
    { 1, 1, 0, 0, 0, 2, 2, 0, 0, 2, 0, 1, 1, 1, 1, 1, 1, 1, 1, 1, 1, 1, 1, 1, 1, 1, 0, 1, 1, 1, 1, 1, 1, 1, 1, 1, 1, 1, 1, 1, 1, 1, 0, 2, 0, 0, 0, 0, 2, 2, 0, 1, 1 },
    { 1, 1, 1, 0, 1, 3, 1, 0, 1, 3, 1, 1, 1, 1, 1, 1, 1, 1, 1, 1, 1, 1, 1, 1, 1, 1, 3, 1, 1, 1, 1, 1, 1, 1, 1, 1, 1, 1, 1, 1, 1, 1, 1, 0, 1, 3, 1, 2, 1, 3, 1, 1, 1 },
    { 1, 1, 1, 3, 1, 0, 1, 3, 1, 0, 1, 1, 1, 0, 0, 0, 0, 0, 1, 1, 1, 1, 0, 1, 1, 0, 0, 0, 1, 1, 0, 1, 1, 1, 1, 2, 0, 0, 0, 0, 1, 1, 1, 3, 1, 2, 1, 3, 1, 0, 1, 1, 1 },
    { 1, 1, 0, 2, 0, 2, 2, 0, 2, 2, 0, 1, 1, 0, 2, 0, 2, 0, 1, 1, 7, 0, 0, 0, 0, 0, 1, 0, 0, 0, 0, 0, 0, 1, 1, 0, 2, 0, 0, 0, 1, 1, 0, 0, 2, 2, 0, 2, 0, 0, 0, 1, 1 },
    { 1, 1, 1, 2, 1, 3, 1, 2, 1, 3, 1, 1, 1, 0, 2, 2, 0, 0, 1, 1, 1, 1, 0, 1, 1, 0, 1, 0, 1, 1, 0, 1, 1, 1, 1, 2, 0, 2, 0, 0, 1, 1, 1, 0, 1, 3, 1, 2, 1, 3, 1, 1, 1 },
    { 1, 1, 1, 3, 1, 0, 1, 3, 1, 2, 1, 1, 1, 0, 2, 2, 0, 2, 0, 0, 0, 0, 0, 0, 0, 0, 0, 0, 0, 0, 0, 0, 0, 1, 1, 0, 2, 0, 2, 0, 1, 1, 1, 3, 1, 0, 1, 3, 1, 2, 1, 1, 1 },
    { 1, 1, 9, 0, 2, 2, 0, 2, 2, 0, 0, 0, 0, 2, 0, 2, 2, 0, 1, 1, 1, 1, 0, 1, 1, 0, 9, 0, 1, 1, 0, 1, 1, 1, 1, 2, 0, 2, 0, 2, 0, 0, 0, 0, 2, 2, 0, 2, 2, 0, 9, 1, 1 },
    { 1, 1, 1, 0, 1, 3, 1, 2, 1, 3, 1, 1, 1, 0, 0, 0, 2, 0, 1, 1, 0, 0, 0, 0, 0, 0, 0, 0, 0, 0, 0, 0, 0, 0, 0, 0, 2, 0, 2, 0, 1, 1, 1, 0, 1, 3, 1, 2, 1, 3, 1, 1, 1 },
    { 1, 1, 1, 3, 1, 0, 1, 3, 1, 2, 1, 1, 1, 0, 2, 0, 0, 0, 1, 1, 1, 1, 0, 1, 1, 0, 1, 0, 1, 1, 0, 1, 1, 1, 1, 2, 0, 2, 0, 2, 1, 1, 1, 3, 1, 0, 1, 3, 1, 2, 1, 1, 1 },
    { 1, 1, 0, 0, 2, 2, 0, 2, 0, 2, 0, 1, 1, 2, 0, 0, 2, 0, 1, 1, 0, 0, 0, 0, 0, 0, 1, 0, 0, 0, 0, 0, 0, 1, 1, 0, 0, 0, 2, 0, 1, 1, 0, 2, 0, 0, 0, 2, 0, 0, 0, 1, 1 },
    { 1, 1, 1, 0, 1, 3, 1, 0, 1, 3, 1, 1, 1, 0, 0, 0, 0, 0, 1, 1, 1, 1, 0, 1, 1, 0, 0, 0, 1, 1, 0, 1, 1, 1, 1, 0, 0, 0, 0, 2, 1, 1, 1, 0, 1, 3, 1, 0, 1, 3, 1, 1, 1 },
    { 1, 1, 1, 3, 1, 0, 1, 3, 1, 0, 1, 1, 1, 1, 1, 1, 1, 1, 1, 1, 1, 1, 1, 1, 1, 1, 3, 1, 1, 1, 1, 1, 1, 1, 1, 1, 1, 1, 1, 1, 1, 1, 1, 3, 1, 0, 1, 3, 1, 0, 1, 1, 1 },
    { 1, 1, 0, 0, 0, 0, 0, 2, 0, 0, 0, 1, 1, 1, 1, 1, 1, 1, 1, 1, 1, 1, 1, 1, 1, 1, 0, 1, 1, 1, 1, 1, 1, 1, 1, 1, 1, 1, 1, 1, 1, 1, 0, 0, 0, 2, 0, 0, 0, 0, 0, 1, 1 },
    { 1, 1, 1, 0, 1, 3, 1, 0, 1, 3, 1, 1, 1, 1, 2, 1, 2, 1, 2, 1, 2, 1, 2, 1, 2, 1, 2, 1, 2, 1, 2, 1, 2, 1, 2, 1, 2, 1, 8, 1, 1, 1, 1, 0, 1, 3, 1, 0, 1, 3, 1, 1, 1 },
    { 1, 1, 1, 3, 1, 0, 1, 3, 1, 0, 1, 1, 1, 1, 0, 1, 3, 1, 3, 1, 0, 1, 3, 1, 3, 1, 3, 1, 3, 1, 3, 1, 0, 1, 3, 1, 3, 1, 0, 1, 1, 1, 1, 3, 1, 0, 1, 3, 1, 0, 1, 1, 1 },
    { 1, 1, 0, 0, 0, 0, 0, 0, 0, 0, 0, 1, 1, 2, 0, 2, 0, 2, 0, 2, 0, 2, 0, 2, 0, 2, 0, 2, 0, 2, 0, 2, 0, 2, 0, 2, 0, 2, 0, 2, 1, 1, 0, 0, 0, 0, 0, 0, 0, 0, 0, 1, 1 },
    { 1, 1, 1, 3, 1, 3, 1, 3, 1, 3, 1, 1, 1, 1, 0, 1, 3, 1, 3, 1, 0, 1, 3, 1, 3, 1, 0, 1, 3, 1, 3, 1, 0, 1, 3, 1, 3, 1, 0, 1, 1, 1, 1, 3, 1, 3, 1, 3, 1, 3, 1, 1, 1 },
    { 1, 1, 1, 0, 1, 0, 1, 0, 1, 0, 1, 1, 1, 1, 7, 1, 2, 1, 2, 1, 2, 1, 2, 1, 2, 1, 9, 1, 2, 1, 2, 1, 2, 1, 2, 1, 2, 1, 2, 1, 1, 1, 1, 0, 1, 0, 1, 0, 1, 0, 1, 1, 1 },
    { 1, 1, 1, 1, 1, 1, 1, 1, 1, 1, 1, 1, 1, 1, 1, 1, 1, 1, 1, 1, 1, 1, 1, 1, 1, 1, 1, 1, 1, 1, 1, 1, 1, 1, 1, 1, 1, 1, 1, 1, 1, 1, 1, 1, 1, 1, 1, 1, 1, 1, 1, 1, 1 },
    { 1, 1, 1, 1, 1, 1, 1, 1, 1, 1, 1, 1, 1, 1, 1, 1, 1, 1, 1, 1, 1, 1, 1, 1, 1, 1, 1, 1, 1, 1, 1, 1, 1, 1, 1, 1, 1, 1, 1, 1, 1, 1, 1, 1, 1, 1, 1, 1, 1, 1, 1, 1, 1 }