char library[MAP_HEIGHT][MAP_WIDTH] = {
    { 1, 1, 1, 1, 1, 1, 1, 1, 1, 1, 1, 1, 1, 1, 1, 1, 1, 1, 1, 1, 1, 1, 1, 1, 1, 1, 1, 1, 1, 1, 1, 1, 1, 1, 1, 1, 1, 1, 1, 1, 1, 1, 1, 1, 1, 1, 1, 1, 1, 1, 1, 1, 1 },
    { 1, 1, 1, 1, 1, 1, 1, 1, 1, 1, 1, 1, 1, 1, 1, 1, 1, 1, 1, 1, 1, 1, 1, 1, 1, 1, 1, 1, 1, 1, 1, 1, 1, 1, 1, 1, 1, 1, 1, 1, 1, 1, 1, 1, 1, 1, 1, 1, 1, 1, 1, 1, 1 },
    { 1, 1, 0, 0, 0, 0, 0, 0, 0, 0, 0, 0, 1, 1, 0, 1, 1, 1, 0, 0, 0, 0, 1, 1, 1, 0, 9, 2, 0, 1, 0, 1, 1, 1, 1, 2, 0, 0, 0, 1, 1, 0, 0, 0, 2, 0, 0, 2, 0, 0, 0, 1, 1 },
    { 1, 1, 2, 1, 1, 0, 1, 1, 3, 1, 1, 0, 1, 1, 0, 1, 1, 1, 3, 0, 0, 0, 2, 0, 2, 0, 0, 0, 1, 1, 3, 1, 1, 1, 1, 0, 0, 2, 0, 1, 1, 0, 0, 2, 2, 2, 2, 2, 2, 0, 0, 1, 1 },
    { 1, 1, 0, 1, 1, 0, 1, 1, 0, 1, 1, 2, 1, 1, 0, 0, 0, 0, 0, 1, 1, 1, 1, 1, 1, 0, 0, 0, 1, 1, 0, 1, 1, 1, 1, 2, 1, 1, 3, 1, 1, 0, 2, 2, 2, 2, 2, 2, 2, 2, 0, 1, 1 },
    { 1, 1, 2, 0, 0, 2, 0, 2, 0, 1, 1, 0, 0, 0, 0, 1, 1, 1, 3, 1, 1, 1, 1, 1, 1, 1, 1, 0, 0, 0, 2, 1, 1, 0, 0, 0, 1, 1, 0, 1, 1, 3, 2, 2, 2, 2, 2, 2, 2, 2, 2, 1, 1 },
    { 1, 1, 0, 1, 1, 1, 1, 1, 1, 1, 1, 1, 1, 1, 3, 1, 1, 1, 0, 0, 0, 0, 1, 1, 1, 1, 1, 1, 1, 1, 0, 0, 0, 0, 1, 1, 1, 0, 0, 0, 0, 0, 2, 2, 2, 2, 2, 2, 2, 2, 0, 1, 1 },
    { 1, 1, 0, 1, 1, 1, 1, 1, 1, 1, 1, 1, 1, 1, 0, 0, 0, 0, 0, 1, 1, 1, 0, 0, 0, 0, 1, 1, 1, 1, 1, 1, 1, 1, 1, 1, 1, 1, 1, 1, 1, 0, 2, 2, 2, 2, 2, 2, 2, 2, 2, 1, 1 },
    { 1, 1, 0, 1, 1, 1, 0, 0, 0, 0, 0, 0, 1, 1, 0, 1, 1, 1, 0, 1, 1, 1, 3, 0, 0, 0, 1, 1, 1, 1, 1, 1, 1, 1, 7, 1, 1, 1, 1, 1, 1, 2, 2, 2, 2, 2, 2, 2, 2, 0, 0, 1, 1 },
    { 1, 1, 3, 1, 1, 1, 3, 1, 1, 1, 1, 0, 1, 1, 0, 1, 1, 1, 0, 0, 0, 0, 0, 0, 0, 0, 1, 1, 1, 1, 1, 1, 1, 1, 0, 0, 0, 0, 0, 1, 1, 2, 2, 2, 2, 0, 0, 0, 0, 0, 0, 1, 1 },
    { 1, 1, 0, 0, 0, 0, 0, 1, 1, 1, 1, 3, 1, 1, 0, 0, 0, 0, 0, 1, 1, 1, 0, 0, 0, 0, 1, 1, 1, 1, 1, 0, 0, 0, 0, 1, 1, 1, 3, 1, 1, 2, 2, 2, 2, 0, 0, 0, 0, 0, 0, 1, 1 },
    { 1, 1, 1, 1, 1, 1, 1, 1, 1, 1, 1, 0, 1, 1, 0, 1, 1, 1, 3, 1, 1, 1, 0, 1, 1, 1, 0, 1, 1, 1, 0, 1, 1, 1, 3, 1, 1, 1, 0, 1, 1, 0, 0, 0, 0, 0, 1, 1, 1, 1, 1, 1, 1 },
    { 1, 1, 1, 1, 1, 1, 1, 0, 0, 2, 0, 0, 1, 1, 0, 1, 1, 1, 0, 0, 0, 0, 1, 1, 1, 1, 0, 1, 1, 1, 3, 1, 1, 1, 0, 0, 0, 0, 0, 1, 1, 1, 1, 1, 0, 0, 1, 1, 1, 1, 1, 1, 1 },
    { 1, 1, 0, 0, 0, 1, 1, 0, 1, 1, 0, 0, 1, 1, 0, 0, 1, 2, 0, 1, 1, 1, 0, 1, 1, 0, 0, 0, 1, 1, 0, 0, 0, 0, 2, 1, 1, 1, 3, 1, 1, 1, 1, 1, 0, 0, 1, 1, 0, 0, 0, 1, 1 },
    { 1, 1, 9, 0, 0, 1, 1, 0, 1, 1, 0, 0, 1, 1, 3, 1, 1, 1, 0, 1, 1, 1, 0, 0, 0, 0, 9, 0, 0, 0, 0, 1, 1, 1, 3, 1, 1, 1, 0, 1, 1, 0, 0, 0, 0, 0, 1, 1, 0, 0, 'D', 1, 1 },
    { 1, 1, 0, 0, 0, 1, 1, 7, 1, 1, 0, 0, 1, 1, 0, 1, 1, 1, 2, 0, 0, 0, 0, 1, 1, 0, 0, 0, 1, 1, 3, 1, 1, 1, 0, 0, 0, 0, 0, 1, 1, 0, 0, 0, 0, 0, 1, 1, 0, 0, 0, 1, 1 },
    { 1, 1, 1, 0, 1, 1, 1, 1, 1, 1, 0, 0, 1, 1, 2, 0, 1, 1, 0, 1, 1, 1, 3, 1, 1, 1, 0, 1, 1, 1, 0, 0, 0, 0, 0, 1, 1, 1, 3, 1, 1, 0, 0, 1, 1, 1, 1, 1, 1, 3, 1, 1, 1 },
    { 1, 1, 1, 0, 1, 1, 1, 1, 1, 1, 0, 0, 1, 1, 0, 1, 1, 1, 0, 1, 1, 1, 0, 1, 1, 1, 0, 1, 1, 1, 1, 1, 1, 1, 3, 1, 1, 1, 0, 1, 1, 0, 1, 1, 1, 1, 1, 1, 1, 0, 1, 1, 1 },
    { 1, 1, 0, 0, 0, 0, 0, 0, 0, 0, 0, 0, 1, 1, 3, 1, 1, 1, 2, 0, 0, 0, 0, 0, 0, 1, 1, 1, 0, 1, 1, 1, 1, 1, 0, 0, 0, 0, 0, 1, 1, 1, 1, 1, 1, 1, 1, 1, 0, 0, 1, 1, 1 },
    { 1, 1, 0, 1, 1, 1, 0, 1, 1, 0, 1, 1, 1, 1, 0, 0, 2, 2, 0, 1, 1, 1, 0, 0, 1, 1, 1, 1, 1, 1, 1, 1, 1, 1, 2, 1, 1, 1, 3, 1, 1, 0, 1, 1, 1, 1, 1, 0, 0, 1, 0, 1, 1 },
    { 1, 1, 0, 1, 1, 1, 0, 1, 1, 0, 1, 1, 1, 1, 1, 1, 1, 1, 0, 1, 1, 1, 3, 1, 1, 1, 1, 1, 1, 1, 0, 1, 1, 1, 2, 1, 1, 1, 0, 1, 1, 1, 1, 1, 1, 1, 1, 1, 0, 0, 1, 1, 1 },
    { 1, 1, 0, 0, 0, 0, 2, 1, 1, 0, 1, 1, 1, 1, 0, 1, 1, 1, 0, 0, 0, 0, 0, 1, 1, 1, 1, 1, 1, 1, 3, 1, 1, 1, 2, 0, 0, 0, 0, 1, 1, 0, 1, 1, 1, 1, 1, 1, 1, 0, 0, 1, 1 },
    { 1, 1, 0, 1, 1, 1, 0, 0, 0, 2, 0, 0, 1, 1, 0, 0, 2, 1, 3, 1, 1, 1, 0, 1, 1, 0, 0, 0, 1, 1, 0, 0, 0, 0, 0, 1, 1, 1, 3, 1, 1, 0, 0, 1, 1, 1, 1, 1, 1, 0, 0, 1, 1 },
    { 1, 1, 0, 1, 1, 1, 0, 0, 1, 1, 1, 0, 1, 1, 0, 1, 1, 1, 0, 1, 1, 1, 0, 1, 1, 0, 0, 0, 0, 0, 0, 1, 1, 1, 0, 1, 1, 1, 0, 1, 1, 0, 0, 0, 1, 1, 0, 0, 0, 0, 0, 1, 1 },
    { 1, 1, 0, 0, 0, 0, 0, 0, 1, 1, 1, 0, 1, 1, 8, 1, 1, 1, 0, 0, 0, 0, 0, 1, 1, 0, 9, 0, 1, 1, 'C', 1, 1, 1, 0, 0, 0, 0, 0, 1, 1, 0, 0, 0, 0, 1, 0, 0, 0, 0, 0, 1, 1 },
    { 1, 1, 1, 1, 1, 1, 1, 1, 1, 1, 1, 1, 1, 1, 1, 1, 1, 1, 1, 1, 1, 1, 1, 1, 1, 1, 1, 1, 1, 1, 1, 1, 1, 1, 1, 1, 1, 1, 1, 1, 1, 1, 1, 1, 1, 1, 1, 1, 1, 1, 1, 1, 1 },
    { 1, 1, 1, 1, 1, 1, 1, 1, 1, 1, 1, 1, 1, 1, 1, 1, 1, 1, 1, 1, 1, 1, 1, 1, 1, 1, 1, 1, 1, 1, 1, 1, 1, 1, 1, 1, 1, 1, 1, 1, 1, 1, 1, 1, 1, 1, 1, 1, 1, 1, 1, 1, 1 }
};