char MerryGR[MAP_HEIGHT][MAP_WIDTH]{
    { 1, 1, 1, 1, 1, 1, 1, 1, 1, 1, 1, 1, 1, 1, 1, 1, 1, 1, 1, 1, 1, 1, 1, 1, 1, 1, 1, 1, 1, 1, 1, 1, 1, 1, 1, 1, 1, 1, 1, 1, 1, 1, 1, 1, 1, 1, 1, 1, 1, 1, 1, 1, 1 },
    { 1, 1, 1, 1, 1, 1, 1, 1, 1, 1, 1, 1, 1, 1, 1, 1, 1, 1, 1, 1, 1, 1, 1, 1, 1, 1, 1, 1, 1, 1, 1, 1, 1, 1, 1, 1, 1, 1, 1, 1, 1, 1, 1, 1, 1, 1, 1, 1, 1, 1, 1, 1, 1 },
    { 1, 1, 7, 0, 2, 0, 2, 2, 2, 2, 0, 2, 0, 2, 0, 0, 2, 0, 2, 2, 2, 2, 2, 2, 1, 0, 9, 0, 1, 2, 2, 0, 2, 0, 2, 0, 2, 0, 2, 0, 2, 2, 2, 2, 2, 0, 0, 0, 2, 0, 6, 1, 1 },
    { 1, 1, 0, 2, 2, 0, 2, 0, 2, 2, 2, 2, 0, 2, 2, 2, 2, 2, 2, 2, 2, 2, 2, 2, 1, 0, 0, 0, 1, 0, 2, 0, 2, 2, 2, 2, 0, 2, 0, 2, 2, 2, 0, 2, 0, 2, 2, 0, 2, 2, 2, 1, 1 },
    { 1, 1, 2, 2, 2, 2, 2, 0, 2, 0, 2, 0, 2, 2, 2, 2, 2, 0, 2, 0, 2, 0, 2, 2, 1, 1, 0, 1, 1, 2, 2, 2, 2, 0, 0, 0, 2, 2, 2, 0, 2, 2, 0, 2, 2, 0, 2, 2, 0, 0, 2, 1, 1 },
    { 1, 1, 0, 2, 2, 2, 2, 2, 2, 2, 2, 2, 0, 2, 2, 2, 2, 0, 2, 2, 2, 0, 2, 0, 2, 2, 0, 0, 2, 0, 2, 2, 2, 2, 0, 2, 0, 2, 0, 2, 2, 2, 2, 0, 0, 2, 0, 0, 2, 2, 2, 1, 1 },
    { 1, 1, 0, 2, 2, 2, 2, 2, 0, 0, 2, 0, 2, 0, 2, 2, 2, 2, 2, 0, 2, 2, 0, 2, 0, 0, 2, 2, 0, 2, 0, 0, 2, 0, 2, 2, 0, 0, 2, 0, 2, 0, 0, 2, 2, 0, 2, 2, 0, 2, 2, 1, 1 },
    { 1, 1, 2, 2, 2, 2, 2, 2, 0, 2, 2, 2, 0, 2, 2, 2, 2, 0, 2, 0, 2, 2, 0, 0, 2, 2, 2, 2, 2, 2, 2, 0, 2, 0, 2, 0, 2, 2, 0, 2, 0, 2, 2, 0, 2, 2, 0, 2, 0, 0, 2, 1, 1 },
    { 1, 1, 0, 0, 2, 0, 2, 0, 2, 2, 2, 2, 2, 2, 2, 2, 2, 2, 2, 2, 2, 2, 2, 2, 2, 0, 2, 2, 0, 0, 2, 2, 0, 2, 0, 2, 2, 0, 2, 0, 2, 0, 2, 0, 2, 0, 2, 2, 2, 2, 2, 1, 1 },
    { 1, 1, 2, 2, 2, 2, 2, 2, 0, 2, 2, 2, 0, 0, 2, 0, 2, 2, 2, 2, 2, 2, 2, 2, 2, 2, 0, 0, 2, 0, 2, 2, 2, 0, 2, 0, 0, 0, 2, 2, 0, 2, 2, 2, 2, 2, 0, 0, 2, 0, 2, 1, 1 },
    { 1, 1, 2, 2, 2, 0, 2, 0, 2, 0, 1, 0, 2, 2, 2, 2, 2, 2, 0, 0, 2, 0, 0, 0, 2, 0, 2, 2, 2, 2, 0, 0, 0, 2, 0, 2, 2, 2, 0, 0, 0, 2, 2, 2, 2, 2, 2, 2, 2, 2, 2, 1, 1 },
    { 1, 1, 1, 1, 1, 0, 2, 2, 0, 2, 2, 0, 2, 2, 2, 0, 2, 2, 2, 2, 2, 2, 2, 2, 1, 1, 0, 1, 1, 2, 2, 0, 2, 0, 0, 2, 2, 2, 2, 2, 2, 2, 0, 0, 2, 0, 2, 2, 1, 1, 1, 1, 1 },
    { 1, 1, 0, 1, 1, 0, 2, 2, 0, 2, 0, 2, 0, 0, 2, 0, 2, 2, 0, 2, 2, 2, 2, 2, 1, 0, 0, 0, 1, 2, 2, 2, 0, 2, 0, 2, 2, 2, 0, 2, 2, 2, 2, 2, 2, 2, 2, 2, 1, 0, 0, 1, 1 },
    { 1, 1, 9, 0, 0, 2, 0, 0, 2, 0, 2, 0, 2, 2, 2, 2, 0, 0, 0, 2, 2, 0, 2, 0, 0, 0, 9, 0, 0, 2, 0, 0, 2, 0, 2, 2, 2, 2, 0, 2, 0, 2, 0, 2, 2, 0, 2, 0, 0, 0, 'K', 1, 1 },
    { 1, 1, 0, 1, 1, 0, 2, 2, 0, 2, 2, 2, 0, 2, 2, 2, 2, 2, 2, 0, 2, 0, 2, 2, 1, 0, 0, 0, 1, 2, 2, 2, 2, 2, 2, 2, 2, 2, 2, 2, 2, 2, 2, 2, 2, 0, 2, 2, 1, 0, 0, 1, 1 },
    { 1, 1, 1, 1, 1, 2, 2, 2, 0, 2, 2, 2, 2, 0, 0, 2, 0, 2, 2, 2, 2, 2, 2, 2, 1, 1, 0, 1, 1, 2, 0, 2, 0, 2, 2, 2, 2, 2, 2, 2, 2, 2, 2, 2, 2, 2, 0, 0, 1, 1, 1, 1, 1 },
    { 1, 1, 2, 2, 2, 0, 2, 2, 2, 2, 2, 0, 0, 2, 2, 2, 2, 2, 0, 0, 2, 2, 2, 2, 2, 2, 0, 2, 0, 0, 2, 0, 2, 2, 0, 0, 2, 2, 2, 2, 2, 2, 2, 2, 2, 0, 0, 2, 2, 2, 2, 1, 1 },
    { 1, 1, 2, 2, 2, 0, 2, 2, 0, 2, 2, 2, 2, 0, 0, 2, 2, 2, 0, 2, 2, 2, 2, 2, 0, 0, 2, 0, 0, 2, 0, 2, 0, 2, 2, 0, 2, 0, 0, 0, 2, 2, 2, 2, 2, 2, 2, 2, 2, 2, 2, 1, 1 },
    { 1, 1, 0, 2, 0, 2, 0, 0, 2, 0, 2, 0, 2, 2, 0, 2, 0, 2, 0, 2, 2, 2, 2, 2, 0, 2, 0, 2, 2, 2, 0, 0, 2, 2, 0, 2, 0, 2, 2, 2, 2, 2, 2, 2, 2, 2, 2, 2, 2, 2, 2, 1, 1 },
    { 1, 1, 0, 0, 2, 0, 2, 2, 0, 2, 2, 0, 2, 2, 2, 2, 2, 0, 2, 0, 0, 2, 0, 0, 2, 0, 2, 0, 2, 0, 2, 2, 0, 2, 2, 2, 0, 2, 2, 0, 0, 2, 2, 2, 2, 2, 2, 2, 2, 2, 2, 1, 1 },
    { 1, 1, 2, 2, 2, 2, 2, 2, 2, 2, 2, 2, 2, 2, 2, 0, 0, 2, 0, 2, 2, 2, 2, 2, 2, 2, 2, 2, 2, 0, 2, 0, 0, 2, 2, 2, 0, 2, 0, 2, 2, 2, 0, 0, 2, 0, 0, 2, 2, 2, 2, 1, 1 },
    { 1, 1, 2, 0, 2, 0, 0, 1, 0, 2, 2, 0, 2, 0, 2, 0, 2, 0, 2, 2, 2, 2, 2, 2, 2, 2, 2, 2, 2, 2, 0, 2, 2, 0, 2, 0, 2, 2, 0, 2, 0, 2, 2, 0, 2, 2, 2, 2, 2, 2, 2, 1, 1 },
    { 1, 1, 0, 0, 2, 0, 2, 2, 0, 2, 2, 2, 2, 2, 2, 2, 0, 2, 0, 2, 2, 2, 0, 0, 1, 1, 1, 1, 1, 2, 0, 2, 2, 2, 0, 0, 2, 2, 2, 0, 0, 2, 2, 2, 2, 2, 0, 2, 0, 2, 0, 1, 1 },
    { 1, 1, 2, 2, 2, 2, 2, 2, 2, 2, 2, 2, 2, 0, 2, 2, 0, 0, 2, 0, 2, 2, 0, 2, 0, 0, 0, 0, 1, 2, 2, 0, 2, 0, 2, 2, 0, 0, 0, 2, 2, 0, 0, 0, 2, 2, 2, 2, 2, 2, 2, 1, 1 },
    { 1, 1, 'E', 2, 2, 0, 0, 2, 0, 2, 0, 2, 0, 0, 2, 2, 2, 2, 2, 0, 2, 0, 2, 0, 1, 0, 'D', 0, 1, 2, 0, 0, 2, 2, 0, 2, 0, 2, 2, 0, 2, 0, 2, 2, 2, 2, 0, 2, 0, 2, 7, 1, 1 },
    { 1, 1, 1, 1, 1, 1, 1, 1, 1, 1, 1, 1, 1, 1, 1, 1, 1, 1, 1, 1, 1, 1, 1, 1, 1, 1, 1, 1, 1, 1, 1, 1, 1, 1, 1, 1, 1, 1, 1, 1, 1, 1, 1, 1, 1, 1, 1, 1, 1, 1, 1, 1, 1 },
    { 1, 1, 1, 1, 1, 1, 1, 1, 1, 1, 1, 1, 1, 1, 1, 1, 1, 1, 1, 1, 1, 1, 1, 1, 1, 1, 1, 1, 1, 1, 1, 1, 1, 1, 1, 1, 1, 1, 1, 1, 1, 1, 1, 1, 1, 1, 1, 1, 1, 1, 1, 1, 1 }
};