char TheH[MAP_HEIGHT][MAP_WIDTH]{
    { 1, 1, 1, 1, 1, 1, 1, 1, 1, 1, 1, 1, 1, 1, 1, 1, 1, 1, 1, 1, 1, 1, 1, 1, 1, 1, 1, 1, 1, 1, 1, 1, 1, 1, 1, 1, 1, 1, 1, 1, 1, 1, 1, 1, 1, 1, 1, 1, 1, 1, 1, 1, 1 },
    { 1, 1, 1, 1, 1, 1, 1, 1, 1, 1, 1, 1, 1, 1, 1, 1, 1, 1, 1, 1, 1, 1, 1, 1, 1, 1, 1, 1, 1, 1, 1, 1, 1, 1, 1, 1, 1, 1, 1, 1, 1, 1, 1, 1, 1, 1, 1, 1, 1, 1, 1, 1, 1 },
    { 1, 1, 1, 1, 7, 0, 0, 0, 1, 1, 0, 2, 0, 2, 1, 1, 6, 2, 0, 0, 1, 1, 2, 0, 0, 0, 9, 0, 0, 0, 0, 1, 1, 0, 0, 0, 0, 1, 1, 0, 2, 'K', 0, 1, 1, 0, 0, 0, 0, 1, 1, 1, 1 },
    { 1, 1, 1, 1, 0, 1, 1, 0, 1, 1, 2, 1, 1, 0, 1, 1, 2, 1, 1, 2, 1, 1, 0, 1, 1, 1, 1, 1, 1, 1, 0, 1, 1, 0, 1, 1, 0, 1, 1, 0, 1, 1, 0, 1, 1, 0, 1, 1, 0, 1, 1, 1, 1 },
    { 1, 1, 0, 0, 2, 1, 1, 2, 0, 0, 0, 1, 1, 0, 0, 2, 0, 1, 1, 0, 0, 0, 0, 1, 1, 1, 1, 1, 1, 1, 2, 2, 0, 0, 1, 1, 0, 2, 0, 0, 1, 1, 2, 0, 2, 0, 1, 1, 2, 0, 0, 1, 1 },
    { 1, 1, 1, 1, 2, 0, 0, 2, 1, 1, 2, 2, 0, 0, 1, 1, 0, 0, 0, 2, 1, 1, 0, 0, 0, 0, 2, 0, 0, 0, 0, 1, 1, 0, 0, 0, 0, 1, 1, 0, 0, 2, 0, 1, 1, 0, 2, 2, 0, 1, 1, 1, 1 },
    { 1, 1, 1, 1, 0, 1, 1, 0, 1, 1, 0, 1, 1, 0, 1, 1, 0, 1, 1, 0, 1, 1, 0, 1, 1, 1, 1, 1, 1, 1, 2, 1, 1, 0, 1, 1, 2, 1, 1, 0, 1, 1, 0, 1, 1, 0, 1, 1, 0, 1, 1, 1, 1 },
    { 1, 1, 0, 0, 0, 1, 1, 0, 0, 0, 2, 1, 1, 2, 0, 0, 0, 1, 1, 0, 0, 0, 2, 1, 1, 1, 1, 1, 1, 1, 0, 0, 2, 0, 1, 1, 0, 0, 0, 2, 1, 1, 0, 0, 0, 0, 1, 1, 0, 0, 0, 1, 1 },
    { 1, 1, 1, 1, 0, 0, 0, 0, 1, 1, 0, 0, 2, 0, 1, 1, 2, 0, 0, 0, 1, 1, 0, 0, 2, 0, 0, 0, 0, 2, 2, 1, 1, 0, 0, 2, 0, 1, 1, 0, 0, 0, 2, 1, 1, 2, 2, 0, 0, 1, 1, 1, 1 },
    { 1, 1, 1, 1, 0, 1, 1, 0, 1, 1, 0, 1, 1, 0, 1, 1, 0, 1, 1, 0, 1, 1, 0, 1, 1, 1, 1, 1, 1, 1, 0, 1, 1, 0, 1, 1, 0, 1, 1, 0, 1, 1, 0, 1, 1, 0, 1, 1, 0, 1, 1, 1, 1 },
    { 1, 1, 0, 0, 2, 1, 1, 2, 0, 0, 0, 1, 1, 2, 0, 0, 0, 1, 1, 2, 0, 0, 0, 1, 1, 1, 1, 1, 1, 1, 0, 0, 0, 2, 1, 1, 2, 2, 0, 0, 1, 1, 0, 0, 0, 0, 1, 1, 0, 0, 0, 1, 1 },
    { 1, 1, 1, 1, 0, 0, 0, 0, 1, 1, 2, 0, 0, 2, 1, 1, 0, 0, 0, 0, 1, 1, 0, 0, 0, 2, 0, 2, 0, 0, 2, 1, 1, 0, 0, 0, 0, 1, 1, 2, 0, 0, 0, 1, 1, 2, 0, 0, 2, 1, 1, 1, 1 },
    { 1, 1, 1, 1, 0, 1, 1, 0, 1, 1, 0, 1, 1, 0, 1, 1, 0, 1, 1, 0, 1, 1, 0, 1, 1, 0, 0, 0, 1, 1, 0, 1, 1, 0, 1, 1, 0, 1, 1, 0, 1, 1, 2, 1, 1, 0, 1, 1, 0, 1, 1, 1, 1 },
    { 1, 1, 9, 0, 0, 1, 1, 2, 0, 0, 2, 1, 1, 2, 0, 2, 0, 1, 1, 2, 0, 0, 0, 1, 1, 2, 9, 0, 1, 1, 0, 0, 0, 2, 1, 1, 2, 0, 2, 0, 1, 1, 0, 0, 0, 0, 1, 1, 0, 0, 'D', 1, 1 },
    { 1, 1, 1, 1, 0, 0, 0, 0, 1, 1, 0, 2, 0, 0, 1, 1, 0, 0, 0, 0, 1, 1, 0, 1, 1, 0, 0, 0, 1, 1, 0, 1, 1, 0, 0, 0, 0, 1, 1, 0, 2, 0, 2, 1, 1, 2, 0, 0, 0, 1, 1, 1, 1 },
    { 1, 1, 1, 1, 0, 1, 1, 2, 1, 1, 0, 1, 1, 0, 1, 1, 0, 1, 1, 0, 1, 1, 2, 0, 0, 0, 0, 0, 0, 0, 2, 1, 1, 0, 1, 1, 0, 1, 1, 2, 1, 1, 0, 1, 1, 0, 1, 1, 0, 1, 1, 1, 1 },
    { 1, 1, 0, 0, 2, 1, 1, 0, 0, 0, 0, 1, 1, 2, 0, 0, 0, 1, 1, 2, 0, 0, 0, 1, 1, 1, 1, 1, 1, 1, 0, 0, 0, 2, 1, 1, 0, 2, 0, 0, 1, 1, 0, 0, 0, 2, 1, 1, 0, 0, 0, 1, 1 },
    { 1, 1, 1, 1, 0, 0, 0, 2, 1, 1, 0, 0, 0, 0, 1, 1, 0, 0, 2, 0, 1, 1, 2, 1, 1, 1, 1, 1, 1, 1, 2, 1, 1, 2, 0, 0, 2, 1, 1, 0, 0, 2, 0, 1, 1, 0, 0, 0, 2, 1, 1, 1, 1 },
    { 1, 1, 1, 1, 2, 1, 1, 0, 1, 1, 0, 1, 1, 0, 1, 1, 2, 1, 1, 0, 1, 1, 0, 0, 2, 0, 0, 0, 2, 0, 2, 1, 1, 2, 1, 1, 0, 1, 1, 2, 1, 1, 2, 1, 1, 0, 1, 1, 0, 1, 1, 1, 1 },
    { 1, 1, 0, 0, 2, 1, 1, 0, 2, 0, 0, 1, 1, 2, 0, 2, 0, 1, 1, 0, 0, 0, 0, 1, 1, 1, 1, 1, 1, 1, 0, 0, 0, 0, 1, 1, 0, 0, 2, 0, 1, 1, 0, 2, 0, 2, 1, 1, 0, 0, 0, 1, 1 },
    { 1, 1, 1, 1, 0, 0, 0, 2, 1, 1, 2, 0, 0, 0, 1, 1, 0, 0, 0, 2, 1, 1, 0, 1, 1, 1, 1, 1, 1, 1, 0, 1, 1, 2, 0, 0, 2, 1, 1, 0, 0, 2, 0, 1, 1, 0, 0, 0, 0, 1, 1, 1, 1 },
    { 1, 1, 1, 1, 0, 1, 1, 0, 1, 1, 0, 1, 1, 2, 1, 1, 2, 1, 1, 0, 1, 1, 2, 0, 0, 2, 2, 0, 0, 0, 2, 1, 1, 0, 1, 1, 2, 1, 1, 0, 1, 1, 2, 1, 1, 2, 1, 1, 0, 1, 1, 1, 1 },
    { 1, 1, 0, 0, 0, 1, 1, 0, 0, 0, 0, 1, 1, 0, 0, 0, 0, 1, 1, 0, 0, 0, 2, 1, 1, 1, 1, 1, 1, 1, 0, 0, 0, 2, 1, 1, 0, 0, 0, 0, 1, 1, 0, 0, 0, 0, 1, 1, 0, 0, 0, 1, 1 },
    { 1, 1, 1, 1, 2, 0, 2, 2, 1, 1, 2, 0, 2, 0, 1, 1, 2, 0, 2, 0, 1, 1, 0, 1, 1, 1, 1, 1, 1, 1, 0, 1, 1, 0, 0, 0, 2, 1, 1, 0, 2, 0, 2, 1, 1, 2, 2, 0, 0, 1, 1, 1, 1 },
    { 1, 1, 1, 1, 0, 0, 2, 0, 1, 1, 6, 2, 2, 0, 1, 1, 0, 0, 2, 2, 1, 1, 0, 0, 0, 0, 9, 0, 0, 0, 0, 1, 1, 0, 0, 0, 0, 1, 1, 2, 0, 0, 2, 1, 1, 0, 2, 0, 2, 1, 1, 1, 1 },
    { 1, 1, 1, 1, 1, 1, 1, 1, 1, 1, 1, 1, 1, 1, 1, 1, 1, 1, 1, 1, 1, 1, 1, 1, 1, 1, 1, 1, 1, 1, 1, 1, 1, 1, 1, 1, 1, 1, 1, 1, 1, 1, 1, 1, 1, 1, 1, 1, 1, 1, 1, 1, 1 },
    { 1, 1, 1, 1, 1, 1, 1, 1, 1, 1, 1, 1, 1, 1, 1, 1, 1, 1, 1, 1, 1, 1, 1, 1, 1, 1, 1, 1, 1, 1, 1, 1, 1, 1, 1, 1, 1, 1, 1, 1, 1, 1, 1, 1, 1, 1, 1, 1, 1, 1, 1, 1, 1 }
};